# Tier 1
Magier: Kampfzauberer, Heiler
Kämpfer: Krieger, Barbar
Techniker: Schütze, Dieb


# Tier 2
Kampfzauberer: Arkanist, Hämonant
Heiler: Seelenmagier, Paladin
Schütze: Jäger, Schnellschütze
Dieb: Kampfakrobat, Assassine
Krieger: Ritter, Mönch
Barbar: Berserker, Plünderer


# Tier 3
Arkanist: Formationsmagier, Phantom, Runenkünstler
Hämonant: Nekromant
Seelenmagier: Gestaltenwandler, Mentalist
Jäger: Attentäter
Kampfakrobat: Klingentänzer, Duellant
Ritter: Erzritter, Paladin, Wächter
Berserker: Kriegsherr, Omen
Plünderer: General
Mönch: Templer
Schnellschütze: Artificer


# Tier 4
Formationsmagier: Manalord, Artificer
Runenkünstler: Manalord, Dunkler Ritter
Mentalist: Orakel, Nekromant
Assassine: Attentäter
Klingentänzer: Waffenmeister
Erzritter: Wächter, Dunkler Ritter
General: Kriegsherr
Paladin:
Templer: Koloss, Omen


# Tier 5
Manalord:
Artificer:
Attentäter:
Duellant:
Waffenmeister:
Kriegsherr:
Omen:
Koloss:
Wächter:
Dunkler Ritter:
Orakel:
Nekromant:
